######....######
#..............#
#..............#
#..##########..#
#..............#
####........####
#..............#
#...########...#
#..............#
######....######
